Obstacles

   0  1  2  3  4  5  6  7  8  9 10 11
00-w0;w0;w0;w0;w0;w0;w0;w0;w0;w0;w0;w0;
01-w0;..;t0;..;..;..;t1;..;..;..;..;w0;
02-w0;..;..;..;..;..;..;..;..;..;..;w0;
03-w0;..;..;..;..;..;..;..;..;..;..;w0;
04-w0;..;..;..;..;..;..;..;..;..;..;w0;
05-w0;..;a2;a2;a2;a2;a2;a2;..;..;t1;w0;
06-w0;..;..;..;..;..;..;..;..;..;..;w0;
07-w0;..;w0;w0;w0;w0;w0;w0;..;..;..;w0;
08-w0;..;..;..;..;..;..;w0;..;..;..;w0;
09-w0;..;..;..;..;..;..;w0;..;..;t0;w0;
10-w0;a2;a2;a2;..;a7;..;w0;..;..;..;w0;
11-w0;w0;w0;w0;w0;w0;w0;w0;w0;w0;w0;w0;
